################
##............##
#..............#
#..............#
#..............#
#........##....#
##......####..##
################
