################################################################
####..###############....#############...####...............####
##.....#############.........########........................###
#.....##############..........######..........................##
#....################.........######....................#......#
#....################....##..#######....................#......#
#...################....############...........................#
#...################....#############..........................#
#....###############...##############..........................#
#....################..#############..........###..............#
#....########...#####..#########..............###..............#
#....#######.....###....########.............###..............##
##....######...............#####............####.....##..##..###
###....#####...............######...........####....############
###.....####..............#######...........###....#############
###......##..........##...#######..................#############
###.................####..######...................#########..##
##..................####...###......................#######....#
#....................##.........................###..####......#
#...###........................................####............#
#...####........................................##.............#
#...####..................................###.................##
#....##...............................########...............###
#............................##......#########..........##..####
#............................###....##########.........#########
##........####...............####...##########.........#####..##
##.......######...............####..#########...........###....#
##......#######................####......###...................#
##....#########........#........####...........................#
###..###########......###.......#####..........................#
##################...#####......######.......###..............##
################################################################
