################################################################################################################################
############.......#######...........#####################......#########################...........###..........###############
###########.........#####.............###################........############..#####.....................#........#######.######
#########............###..............###################........###########....###....................###........######...#####
########...............................#################........############..............##..........#####........######...####
########......................##........################........############.........########.........#######......#######..####
###....##....................####........##############........#############........#########..........#######.....########.####
##......##..................######.......#############.........#############.......#########...........########....########...##
##......###.................###########.#############..........############.........#..####...........##########...########....#
###.....####........##.....#########################..........#########.................##............##########...#######.....#
###.....####.......##.....##########################.........########.................................#########.....######.....#
###.....####......###....###########################........#####..................###.................########......####.....##
###......##.......##.....###########################.......#####...................####................########.......##.....###
###..............###......########....################.....#####...................####................########.............####
###...........######.......######......################....######...##..##........####.................########..........#######
###...........######........#####......################.....######.########........##..................#######..........########
##.........##..######........#####.....###############......##############............................#####........#############
#.........###...#######......#####.....##############.......############............................######........##############
#........####...########.....####.......#############.......###########..........................########.........######..######
#.......####...#########.....###........##############......###########.......................############.....########....#####
##......####..#########......##.........##############..........########.....................#######...####...########.....#####
###......##....#######.................###############...........########......##...........#######.....####...###........######
####...............##..................###############...........#########....####.........#######.......###............########
#####...................................##############..........##########...######.......#######......................#########
#####...................................###############.........####################....#########......................#########
#####...............##...................##..###########........#####################..###########..#.................##########
####...............####......................############...........##################.###############...............###########
###................####.....................#############.............###############..###############...............###########
###................#####...................#############...................##.....##....#############.................##########
###.....####........####...###............##########..........................................######....................########
#############........##....###..........###########.............................................##...............##........#####
#################..........###.........############.......###...................................................####........####
#################...........#..........############......####...................................................####.......#####
#################.......................###########....######.............................###....................##.....########
##############....................##.....###########..#####..............................#####.......##................#########
#############....................####.....################.......................##......#####......####....##.........#########
############.....................####......##############.......................####....#######.....#####..#######......########
###########......................#####......############.......................#################....######..########.....###..##
###########.......................#####.....########...........####..........###################....######....#######..........#
############......................#####.....#######...........#######.......#####################...#####.....#######..........#
#############......................###.......#####...........###########....######################..####......#######..........#
###############....##..............####......#####...........############...######################...##.....##########.........#
######################............######......####...........######..#####.#######################.........#############.......#
######################............######.......##............#####....############################........###############......#
#################..###...........######.......................##......#################..#########........################.....#
################.......##.....########..................................##############....#######.........####..###...#####....#
################......####...#########...............................#.........######................##..####..........####....#
################......####...######.............###..##.............####............................#########...........##.....#
##################.....##....#####.............########............#####............................#########..................#
###################............###...........##########........#########...................##.......##########.................#
###################..........................#########........##########..................####.......##########...##...........#
###########..#####..............................#####.........#########...................####........###############.........##
##########....###................................##..........#########.....................###.........##############.........##
##########............##......##............................#########........##............###..........###...######..........##
##########............##.....#######........................#####............##............####................####...........##
###########...........##.....########.......................####............###............##########.........................##
###########..................#######........................####...........####............###########........................##
##########....................######....#...........##.......##...........####.............###########.........................#
########........................####...###.........####............##.....####..............####...##..........................#
#######..........................#########........########........####.....####.............................##.......##........#
######...........................##########......##########......#####......######.......................######.....#######....#
######............###...........############.....###########..#########......######.....................########...########....#
#######.....##########......#################...########################....########.....###...###.....#####################..##
################################################################################################################################
