################################################################################################################################
########################.....####.....##########......####......................###......####...##################.####.......##
####.#################..................######.....#....#.................#..............####....################..###.........#
###...#############.....................####......###.............##.....#######..........##.....###############...##..........#
###...#############...............####..####.....####.............###....########................###############...............#
##....#############..............######..#####..#####......#......###...#########....##...........#############...........###..#
##....##############...###......###..###..##########.....########.####.#########....###............###########............####.#
##....################.#####.........###...########......##..##################....####......##.....####..###.............###..#
##....################..#######...............####......##.....####..##########...######......##....###.............###...###..#
##......#############....######...............####.......#............######..###########......##....#.............##########.##
#........##########.......#####...............####...................######..#############....####.................#############
#........#########.........####..............#####.........##........######.###############...#####...##............############
#.......#######............####.............#######.......####......#######..####......###....#####..#####...........########..#
##.....#######..............###..............########....#####......#######...####............#####...######.........####.###..#
###.....##..#................##................#######...####........######...#######.........######....#####........####......#
####.........................##................######....###..........####.....#######........#####.....#######......#####.....#
#####................###....###...............######.....##...................###########.....####.....########.......#####....#
######...............####...###....###........#####.....##...................##############....###....########.........###.....#
#######...##..........##....#####.####........#####.....##.....#............#################...##....#####.#...........##.....#
#######...##########.........########..........#####...####...##..........###################...###....####......###...####....#
#######...##########..........############........########....##.........####################...###.....######....##...#####...#
########.###########.............#########.........######....###.........####################....##......######.........####...#
####################..............#########.##.....#####.....###....##...####################.............#####..........##....#
########.##########..............####.########.....####.....##########...####################........##...####.................#
#######....######...............####...#######.....####...###########....####################.......####.#####...............###
#######.....####...............####....######.......###..###########.....###################........##########..............####
########.....###...............###......####.........#....#########......###.......######............#########.............#####
#....####....##..........###...###.......###..##...........###.####......##........#####..............########.............#####
#....####................####.#####..........#######.......##...#######.##........######..............###..####............#####
##....###..........##....##########.........########......###....#######..........####...............###....####......#....#####
##................#####.##########..........##.######....#####.......##...........###.........#.....###......###....#.....######
#.................#################.............#####..#######.....................#.........###.............###....#.....######
##........####.....################..............#############....................#.........####.............##...........######
###......#####.....######.....#####...............############...................###........###...........................######
####....####.......#####......####....#...........############...###............#####......###..#............................###
####...###.......######........##.................###########...####...........######.....##########.....#....................##
####....#........######........##......##....#....##########...####........###..#####......##########..#####.......##.........##
####.............#####..###...#####...#######.....#########....###.........####.#####.......#################.....####.......###
###..............####...####..#...###########.....#######.......##.........##########........################......##...#..#####
##.............###......#####......#########.......#####...................###########.......##########....###.........#########
##......##....####.......####......######...........####.....##..#..........#..#######......###########.....##.........#########
#......####....###.......####.......####..............###....######.............###.##.....#########....................########
#......####................#.......#####...............#####..######.................##....#######.....###...............#...###
#.......###.......##.#.............####...............######.....########............###....######.....###....................##
#####....##......#####.....................##.........######......########......##...####...#######....##......#...............#
######...##.....######.....##..............###.......#######.......##########...##....####...########..........#...............#
######...##....######...######.............####....#########.........########...##....#####..#########.........................#
#######........#####...######..............####...###########...........#####.........#####...########.......................###
###..###......######..####......#..........###...#############......###..####.........#####...............#................#####
#............########..##......###..........#...##############.....####..#####...##...####.................................#####
#...........#############.....##########......################.....###....####...##.............................#####......#####
#...........############......###########....################.....###........#..###............................######.........##
#..........#########..##.......##.########..#################....####..........###............................####.............#
#..........#######.................#######.###################..#####.......#####.....#........................................#
##....###..######....................#################################......###......###.......................................#
###.############......................###############################.......###......###..........#####....................#####
############.........###.............################################........###########.........#######.....#####........######
###########...........###......####..###############################..........##########.........######.....######........######
###########............#####...#####.###############################..........##########.........####.......#####..........#####
###########............#####....#####################################........#########.#........####.........####...........####
#########.............#######...######################################.......#########......##..###...........####....#.....####
########....##.......##################################################......#########.#....#######............#####........####
########...####.....####################################################.....#############.########............######......#####
################################################################################################################################
