=|.|.................|.|.|.........|....=
...|...|.|----------.|.|...-..-...-..-...
...................|...|...|.|.|.|.......
----.|-..-.-.|-..-.|..-|.--|.|.....-...|.
.....|.......|.|.......|.......|.........
.|--..---........|.|.-.---.----..|.--|...
.|.....|.|...|...|...............|...|...
--.|--.|.|.|.|--.|---..--|.|...---.|.|.|.
.......|.|.|...|.......|.|.....|...|.....
.-.-......- -..|-.-..|.|...--....|.--.-|.
.....|...|.|.....................|.......
.--.- --.|.|-.----.|--.|.|.---.|...|.--|.
...|.|.............|...|.......|.........
.-.|.|--.|.--..|--.|.|.|..---.-.-.- ---..
.........|.....|...|.|.|.....|...........
-...--.|--.|..-.--.|.-...|.|.|.....|.-- .
...................|.................|.|.
.-.-.|...|..--.|.|.-.-.|.--|...|.-..-..|.
.....|.|...|.|.|.........................
.|...|--.---.|.-..--.|..----..--.|.|.-.|.
=|.|.............|.....|.........|.|...|=
