################################################################################################################################
############.....↑.#######...........#####################......#########################@........←@###..........###############
###########......@..#####.............###################..@.....############..#####.....↓.............@.#........#######.######
#########..........@.###..............###################..↓.....###########....###....................↓##........######@→.#####
########...........↓...................#################........############........@.....##..........#####..@→....######...####
########......................##........################........############........↓########.........#######......#######..####
###....##....................####....@→↑.##############........#############..←@....#########..........#######.....########.####
##...←@.##..................######.....@.#############.........#############.......#########...........########....########...##
##@→...@→##.................###########.#############..........############.........#..####...........##########...########....#
###.....####........##....@#########################........←@#########.................##............##########...#######.....#
###.....####.......##.....↓#########################.........########.................................#########.....######.....#
###.....####......###@→..###########################......↑.#####..................###..←@.............########......####.....##
###......##@→.....##.....###########################......@#####...................####................########.......##↑....###
###.......@→.....###......########....################.....#####...←@..............####.....↑..........########.........@...####
###...........######.......######......################....######.↑@##.@##........####......@..........########..........#######
###.......↑...######←@......#####..@→..################.....######@↓###↓###........##..................#######..........########
##........@##..######........#####.....###############......##############............................#####.@→.....#############
#.........###...#######......#####.....##############.......############..................↑.......@.######........##############
#........####...########.....####.......#############..↑....###########...................@......#↓######@→.......######←@######
#.....@→####...#########.....###.↑......##############.@....###########.......................############@↑...########....#####
##......####..#########......##..@......##############..........########.....................######↑...####@..########.....#####
###......##....#######.................###############@..........########......##.........↑@→######@..@→####...###.......@→#####
####..............@→#..................###############↓..........#########..←@####........@#######.......###...........@→#######
#####...................................##############..........##########...######.......#######.....................↑#########
#####...................................###############..@......####################....#########................←@...@#########
#####...............##...................#←@.###########.↓......#####################..###########..#.................##########
####...............####......................############...........#################↑.###############...............###########
###................####.....................#############.............###############@.###############...............###########
###................#####...................#############...................##.....##@→..#############.................##########
###.....####......@→####...###............##########←@.........↑..............................######.....←@.............########
#############........##....###..........###########............@................................##...............##........#####
#################..........###........@→###########.......###.................................↑.................####......←@####
#################...........#....←@....############..↑...####.................↑...............@.................####.......#####
#################.......................###########..@.######.................@...........###....................##.....########
##############....................##@....###########@→#####..............................#####.......##................#########
#############....................###↓.....################.@.....................##......#####......####....##.........#########
############.....................####.@→...##############..↓....................####....#######.....#####..######←@.....########
###########......................#####...←@.############.......................#################....######..########.....###..##
###########.......................#####.....########...........####..........###################....######....#######...←@....↑#
############@→....................#####@→...#######...........#######.......#####################...#####.....#######.........@#
#############....................←@###@......#####...........###########..↑.######################..####......#######......@→..#
###############....##..............###↓......#####...........############.@.######################...##.....##########.........#
######################............######......####...........######..#####.#######################.........#############.......#
######################............######.......##............#####.↑..############################........###############......#
#################..###...........######.......................##...@..################←@.#########........################.....#
################←@.....##.....########...@.................←@.....@.....##############....#######.........####..###...#####....#
################.....↑####...#########...↓.........↑..............↓..#......←@.######................##..####..........####....#
################..@→.@####...######...@.........###@.##.............####............................#########...........##.....#
##################..←@.##....#####.@→.↓@.......########............#####....................@↑......#########.....@→...........#
###################............###.....↓.....##########........#########...................##@......##########.................#
###################...................↑......#########......←@##########..................####.......#########←@..##...........#
###########..#####....................@.........#####.........########←@................↑.####........###############.........##
##########....###↑...............................##..........#########.....←@...........@..###.@.......##############.........##
##########.......@....##......##...................@........#####↑###........##............###.↓...←@...###...######..........##
##########............##.....#######...............↓......@→#####@...........##............####........@→......####.........←@##
###########↑..........##.....########...←@..................####............###............##########.........................##
###########@.................#######....@→..................####...........####........@...###########........................##
##########....................######....#.←@........##.......##...........####.........↓...###########.....................@...#
########........................####...###.........####............##.....####..............####...##......................↓...#
#######..........................#########........########........###←@....↑###.............................##......@→#........#
######................@→........@→#########..↑...##########......#####.....@######...............↑.......######.↑...#######....#
######............###...........############.@...###########..#########....←@######..............@......########@..########..@.#
#######.....##########...@..#################...########################....########.....###...###.....#####################.↓##
#########################↓######################################################################################################
