########################################################################################################↑#######################
############←@.....#######......@....#####################←@..←@####################↑####...........###.@........###############
###########.........#####.......↓.↑...###################........############..#####@....................#←@......#######.######
#########............###..@.......@...###################@→......###########..←@##←@...................###........######←@.#####
########..................@............#################........############.............@→#..........#####..@→....######@→.####
########......@→..............##........################........############.........########.........#######......#######..####
###...@→#.......←@...........####........##############........#############........#########..........#######.....########.####
##....←@##..................######.......#############.........#############.......#########...........########....########...##
##......###............@→...###########.#############..........############.........#..####...........##########...########....#
###.....####........##.←@..#########################..........#########.................##............##########...#######.....#
###.....####.......##.....##########################......↑..########..................@→.............#########.....######.....#
###.....####......###....###########################......@.#####@................↑###...............←@########......####.....##
###......##.......##.....###########################.......#####.↓................@####................########.......##.....###
###..............###......########....################.....#####...................####................########.............####
###...........######.......######......################....######...##.@→#........####.................########..........#######
###........@..######..@→....#####....@→################.....######.########.@......##..................#######↑.........########
##.........↓#..######...@→...#####.....###############.....↑##############..↓..............↑.......↑.@#####...@....#############
#.........###...#######......#####.....##############......@############...................@.↑.....@#↓####........#######↑######
#........####...########.....####.......#############.......###########......................@...########@↑.......######.@######
#.......####...#########.....###.↑......##############......###########.......................############@....########....#####
##......↑###..#########....←@##..@......##############..........########..↑..................#######...####...########↑....#####
###.@→..@##....#######.................###############...........########.@....##...........#######.↑...####...###....@...######
####............←@.##..................###############...........#########....####.........#######..@....###............########
#####...................................##############......@→..##########...######.......#######......................#########
#####...................................###############.........####################..@.#########..@...................#########
#####...............##..@→...............##@.###########........#####################.↓###########.↓#.................##########
####...............####....................↓.############...........##################.###############...............###########
###................####.....................#############.............###############..###############...............###########
###................#####....@..............#############...................##.....↑#....#############.................##########
###.....####........####...#↓#............##########←@..↑.........................@@..........######..........←@........########
#############........##....###..........###########.....@......................................@→#...............##.......@#####
#################..........###.........############.......###...................................................####......↓@####
#################@..........#..........############......####...................................................####.......#####
#################↓.←@........@..........###########....######.............................###.......@..↑.........##.....########
##############...............↓....##.....###########@→#####..←@..........................#####......↓##@...............#########
#############....................####.....################.....................@.##......#####......####....##.........#########
############@....................####@@....##############...↑..................↓####....#######.....#####..#######......########
###########.↓....................#####...←@.############....@..................#################....######..########.....###..##
###########.......................#####.....########..........@####..........###################....#####↑....#######.←@....←@.#
###########←@...................←@#####.....#######...........↓######.......#####################...#####@..←@#######..........#
#############......................###@→.....#####...........###########....######################..####......#######@→........#
###############....##..............####......#####.........↑.############.↑@######################...##.@...##########.........#
######################............######....←@####.........@.######..#####@#######################......↓..#############.......#
######################.@..........######.......##............#####....############################........###############......#
#################..###.↓...@→....######↑......................##......#################..#########........################.....#
################.....←@##.....########.@................................##############....#######.........####..#↑#...#####....#
################......####...#########...............←@..............#.....@→@.######....@...........##..####....@.....####....#
################..↑...####...######.............###..##.............####.................↓.......@→.#########...........##.....#
##################@....##....#####.......@....@########...........@#####............................#########..................#
###################............###.......↓...#↓########........###↓#####........@→.........##.......##########.................#
###################..........................#########........##########..................####.......##########...##...........#
###########..#####..............................#####.........#########...................####........###############.........##
##########.↑..###................................##..........#########..................↑..###.........↑#############.........##
##########.@..........##......##...............←@...........#########........##.........@..###.@→......@###...######..........##
##########............##.....#######........................#####↑...........##............####.......←@.......####...........##
###########.......@→..##.....########.......................####.@.........@###............##########←@............@..........##
###########.......←@.........#######........................####↑..........↓###............###########.............↓..........##
##########....................######....#...........##.......##.@.........####.............###########.........................#
########...................@....####...###.........####............##.....####..............####...##..........@→..............#
######←@...................↓.....#########........########........####.....####.............................##.......##........#
######...........................##########......##########......####←@.....######.......................######.↑...#######....#
######............###...........############.....###########..#########....←@######................@→...########@..########....#
#######.....##########......#################...########################....########...@→###...###.....#####################..##
################################################################################################################################
