########################################################################################################↑#######################
############.......#######...........#####################......#########################...........###.@........###############
###########.........#####.............###################.↑......############..####←@....................#........#######.######
#########............###.@............###################.@......###########....###↑........↑..........###........######@→.#####
########.................↓..@→.........#################.....@→.############.......@.....@→#@.........#####.......@→#####←@.####
########......................##........################........############.........########.........#######......#######..####
###....##.............@......####.@→.....##############........#############........#########..........#######.....########.####
##←@.←@.##..@.........↓.....######.......#############.........#############@→.....#########...........########....########...##
##@→....###.↓...............###########.#############..........############.........#..####...........##########...########....#
###.....####........##.....#########################..........#########@................##............##########...#######.....#
##←@....####.......##.....##########################.........########..↓..............................#########.....######.....#
###.....####.....↑###@...###########################........#####..................###←@...............########......####.....##
###......##......@##.↓...###########################.......#####...................####....@...........########.......##.....###
###........@→....###......########....################.....#####..........↑........####....↓...........########.........↑...####
###...........#####←@......######......################....######.↑@##..##@.......####.................########.........@#######
###@→.....↑...######@→......#####......################.....######@########.↑......##..................#######@.........########
##.......@@##..######..@→....#####.....###############......##############..@.............↑...........#####...↓....#############
#.........###...#######......#####.....##############.......############..................@......@→.######........##############
#........####...########.....####.......#############.......###########..........................########@→.......######..######
#.......####...#########...@.###........##############......###########.....................↑.############.....########@@..#####
##......↑###..#########....↓.##.........##############.........@########....................@#######...####...########.↓↓..#####
###.....@##....#######.................###############........↑↓.########......##...........#######.....####...###........######
####@→.........←@..##..................###############........@..#########....####.........#######.......###............########
#####...............←@..................##############..........##########...######.......#######.....................↑#########
#####@..................................###############.........####################....#########.....................@#########
#####↓..............##←@.................##..###########........#####################..###########..#.................##########
####...............####......................############...........#################↑.###############...............###########
###................####...................↑@→############.............###############@.###############...............###########
###.......@........#####..................@#############.................←@##.....##@→..#############...............←@##########
###.....##↓#........####...###............##########....←@....................................######....................########
#############........##....###..........###########..↑..@....................@↑................@→#..@............##←@......#####
#################..........###.........############..@....###................↓@.....................↓.@→.....@..####.......@####
#################...........#.@........############......####................................................↓..####.......#####
#################.←@.........@↓.........###########....######...................←@........###....................##.....########
##############...............↓....##.....###########..#####.....................@→.......#####.......##@→..............#########
#############....................####.....###############↑.......................##......#####......####....##.........#########
############.....................####......#############↑@....................↑.####....#######.....#####..#######..↑...########
###########...............@......#####.@....############@.................↑...@#################....######..########@....###..##
###########.↑.............↓......@#####↓....########...........####.......@..###################....######....#######...←@....↑#
############@....................↓#####.@...#######...........#######.......#####################...#####.....#######.........@#
#############......................###@→↓....#####........@→.###########....######################..####......#######....@→....#
###############....##..............####......#####...........############..@######################...##.....##########.........#
######################............######......####...........#####←@.#####.↓######################.........#############.......#
######################............######.......##............#####....############################........###############......#
#################..###........@→.######................↑......##......#################..#########........################.....#
################←@.....##.....########.................@................##############....#######.........####..###...#####....#
################......####...#########...............................#←@.......######................##..####..........####....#
################......####...######...........@→###←@##.............####............................#########...........##.....#
##################.....##....#####.............########............#####......@.....................#########..................#
###################............###...........##########........#########......↓............##.......##########.................#
###################.................@........#########........##########..................####.......##########...##...........#
###########..#####.................↑↓...........#####@→.......#########...................####........###############.........##
##########....###..................@.............##..........#########.....................###........↑##############.........##
##########............##......##...................@.......@#########........##............###.....@→.@.###...######..........##
##########............##.....#######...............↓.......↓#####↑...........##↑...........####...........←@...####...........##
###########.....↑....@##.....########.↑.....................####.@..........###@...........##########.........................##
###########.....@....↓.......#######..@.....................####...........####............###########↑.......................##
##########....................######....#...........##......@→#...........####.............###########@........................#
########........................####...###.........####............##....@####...@.........@→###...##......↑...................#
#######......@...................#########@.......########........####...←@####..↓.........................@##.......##........#
######.......↓........↑..........#########↓......##########......#####......######.......................######.....#######....#
######.........@→.###.@.........############.....###########..#########....←@######.....................########...########....#
#######.....##########......#################...########################....########.@→..###...###.....#####################..##
################################################################################################################################
