################################################################################################################################
############←@.....#######...........#####################......#########################...........###..........###############
###########.........#####.............###################........############..#####......←@.............#...←@...#######.######
#########............###.........↑....###################........###########....###....................###........######@→.#####
########.........................@...↑.#################........############.............@##..........#####.....←@.######@..####
########......................##.....@..################........############.......@.####↓###.........#######......######↓..####
###....##←@..................####........##############........#############.......↓#########..........#######.....########.####
##...@..##..................######.....↑.#############.........#############.......#########...........########....########...##
##...↓..###.................###########@#############..........############.........#..####...........##########...########...@#
###.....####........##....@#########################..........#########.................##............##########...#######....@#
###.....####.......##.....↓#########################...←@....########..@..............................#########.....######...←@#
###.....####.↑....###....###########################.↑......#####......↑...........###.................########......####....@##
###..@...##..@....##.....###########################.@.....#####.......@.....↑.....####................########.......##↑....###
###..↓...........###......########....↑##############←@....#####@→...........@.....####........←@......########......@→.@...####
###...........######...↑...######.←@..@################....######...##..##........####.................########..........#######
###...........######...@....#####....@→################...@.######@########.↑......##.@→...............#######..........########
##.........##..######........#####.....###############....↓.######↓#######..@.........................#####........#############
#.........###...#######....↑.#####.....##############.......############............................######........##############
#........####...########...@.####.......#############.......###########..........................########@........######..######
#.......####...#########.....###........##############......###########.......................############@↑...########@...#####
##..@→..####..#########......##.........##############..........########.....................#######←@.####@↑.########.↓...#####
###.@→...##....#######.................###############.........@.########......##...........#######.....####@..###........######
####.............@.##..................###############.........↓.#########....####.........#######.......###............########
#####............↓.....................@##############.....@→...##########...######.......#######..↑.@→................#########
#####..................................↓###############.........####################....#########..@..................@#########
#####...............##...................##..###########........#####################@.###########..#.................↓#########
####...............####......................############.........@.#################↓.###############...............###########
###................####.....................#############.........↓...###############..###############...............###########
###........@.......#####...@...............##########↑##...................##.....##....#############.................##########
###.....###↓.←@.....####...↓##............##########@@..........................@→............######................↑...########
#############........##....###.......←@.###########.↓...........................................↑#...............##@@......#####
#################..........##↑.........############.......###...................................@...............####.......@####
#################@..........#@.........############......####...................................................####.......#####
#################↓......................###########.@↑.######.............................###.......↑............##.....########
#############←@.............@→....#←@....###########↓@#####.....................↑...@....#####......@##................#########
#############........@...........####.....↑###############......................@##.↓....#####......####....##.......↑.#########
############.........↓.......↑...####.....@##############.......................####....#######.....#####..#######...@..########
###########..................@...#####......############...........←@..........#################....######..########.....###..##
###########.......................#####.....########...........####..........###################....######....#######....←@....#
############......................#####.....#######.@.........#######.←@....#####################...#####.....#######..........#
#############......................###@↑.....#####..↓........###########....######################..####......#######..........#
###############....##..............####@.....#####...........############.↑@######################...##...@.##########.........#
######################............######↑.....####...........######..#####@#######################........↓#############.....↑.#
######################.........←@.######@......##............#####....############################........###############....@.#
#################..###.........@→######.......................##......#################..#########........################.....#
################.....↑.##.....########..................................##############....######←@........####..###...#####....#
################@....@####...#########............................@↑.#.←@......######................##.@→###..........####....#
################↓.....####...######.............###..##...........↓@####............................#########...........##.....#
##################.....##....#####.............########............#####............................#########...@→.............#
###################............###...........##########........#########................↑..##.......##########.................#
###################.........................@→########........##########................@.####.......##########...##...........#
###########@.#####..............................#####....@→...#########...................####........###############.........##
##########.↓..###..................@→.↑......@→..#←@.........#########.....................###←@.......↑#############.........##
##########............##......##......@.....................#########........##............###.....@...@###...######..........##
##########............##.....######←@.......................#####..........←@##............####....↓...........####.........@.##
###########...........##.....########...............↑.......###←@...........###............##########.......................↓.##
###########..................#######................@.......####...........####............###########........................##
##########....................######....#...........##.......##...........####.............###########..............↑..←@......#
########..................@→....####...###.........####..........@.##.....####..............####...##...............@........@→#
#######..........................#########........########.......↓####.....####.............................##.......##........#
######...........................##########......##########......#####...@→.######.......................######.....#######....#
######........@...###...........############.....###########..#########.....@######........@→...........########...########....#
#######.....##↓#######......#################...########################....########.....##←@..###.....#####################..##
################################################################################################################################
